PHHHHHHHHHHHHHHHHHT
V  *   *   *   *  V
V PHT W CHA W PHT V
V V V*V     V*V V V
V LHJ V W W V LHJ V
V     V*V V*V     V
V PHHHJ N N LHHHT V
V*V *         * V*V
V N CHHHA CHHHA N V
V   *  X+++   *   V
V CHHHA*PHT*CHHHA V
V  *    V V    *  V
V PHT W LHJ W PHT V
V V V V  *  V V V V
V*LHJ*V*PHT*V*LHJ*V
V     V V V V     V
V*CHHHJ LHJ LHHHA*V
V                 V
LHHHHHHHHHHHHHHHHHJ